====================
=====############===
==###----#------#===
===#-------------#==
=#------###------#==
###,------#-----#===
=#=------------#====
==#-------,-----#===
===#---##------#====
====##---#-##=======
======####==========
====================